20 20
1s111111111111111111
10000000000000000001
11111111111011111101
10000000000000000001
11011111111111111111
10000000001000000001
10101111111011111101
10101000001010000001
10101011101011010101
10101000101000010101
10101111101010110101
10101000001010000101
10101111111010110101
10100000001010110101
10111111101010010101
10100000001011010101
10101011011010010101
10111011011011110101
10000000000010000101
111111111111111111t1