10 10
1s11111111
1000000000
1011111101
1010000101
0010101000
1011101101
1000000010
1010101000
1011111110
00000000t1