10 10
1s11111111
1000000001
1011111101
1010000101
1010101001
1011101101
1000000011
1010101001
1010000101
11111111t1